5
5
+-+-+-+-+-+
|* * *| | |
+-+-+ + + +
|* *|*| | |
+ + + + + +
|*|*|*| | |
+ + + + + +
|*|* *| | |
+ +-+-+ + +
|* * * * *|
+-+-+-+-+-+
