20
15
+-+-+-+-+-+-+-+-+-+-+-+-+-+-+-+-+-+-+-+-+
|* * *      |* *    |         |   |* *  |
+ +-+ +-+-+ + + +-+ +-+ +-+-+ + + + + + +
| |* *|     |*|* *| |   |* *|   | |*|*| |
+-+ + +-+-+-+ +-+ + + + + + +-+-+ + + + +
|* *| |* * * *|* *| | | |*|* * *| |*|*| |
+ +-+-+ +-+-+-+ +-+ + +-+ +-+-+ +-+ + + +
|*|* *|*|   |* *|   | |* *|   |* *|*|*| |
+ + + + + + + +-+ +-+ + +-+ + +-+ + + +-+
|* *|* *  | |* *|     |*|   |   |* *|* *|
+-+-+-+-+-+-+-+ +-+-+ + +-+ +-+ +-+-+-+ +
|         |   |* *|   |* *| |     |   |*|
+ + +-+-+ + + + + + +-+-+ + +-+-+ + +-+ +
| | |   |   | | |*| |* *|*|     |   |* *|
+ + +-+ +-+-+ + + +-+ + + + +-+ +-+-+ + +
| |   |   | | | |* * *|* *|   |     |*| |
+ +-+-+-+ + + + +-+-+-+-+-+-+-+-+-+ + +-+
|     |   |   | |                 | |* *|
+-+-+ + +-+ +-+ +-+ +-+-+ +-+-+-+ + +-+ +
|   |   |   |   |   | |   |     |   |* *|
+-+ +-+-+ +-+ +-+ +-+ + +-+ +-+ +-+-+ +-+
|       | |       | |   |   |       |* *|
+ +-+-+-+ +-+-+-+-+ + +-+ +-+-+-+-+ + + +
|       | |       | |   |       |   | |*|
+ +-+-+ + + +-+-+ + +-+ +-+-+-+ + +-+ + +
| |   | |   |   | |       |     |   | |*|
+ +-+ + +-+-+ +-+ +-+-+-+-+ +-+-+-+ +-+ +
| |   | |   |   | |   |     | |   |   |*|
+ + + + + + + + + + + + +-+-+ + + +-+ + +
|   | |   |   |     |   |       |      *|
+-+-+-+-+-+-+-+-+-+-+-+-+-+-+-+-+-+-+-+-+
