20
15
+-+-+-+-+-+-+-+-+-+-+-+-+-+-+-+-+-+-+-+-+
|           |       |         |   |     |
+ +-+ +-+-+ + + +-+ +-+ +-+-+ + + + + + +
| |   |     | |   | |   |   |   | | | | |
+-+ + +-+-+-+ +-+ + + + + + +-+-+ + + + +
|   | |       |   | | | | |     | | | | |
+ +-+-+ +-+-+-+ +-+ + +-+ +-+-+ +-+ + + +
| |   | |   |   |   | |   |   |   | | | |
+ + + + + + + +-+ +-+ + +-+ + +-+ + + +-+
|   |     | |   |     | |   |   |   |   |
+-+-+-+-+-+-+-+ +-+-+ + +-+ +-+ +-+-+-+ +
|         |   |   |   |   | |     |   | |
+ + +-+-+ + + + + + +-+-+ + +-+-+ + +-+ +
| | |   |   | | | | |   | |     |   |   |
+ + +-+ +-+-+ + + +-+ + + + +-+ +-+-+ + +
| |   |   | | | |     |   |   |     | | |
+ +-+-+-+ + + + +-+-+-+-+-+-+-+-+-+ + +-+
|     |   |   | |                 | |   |
+-+-+ + +-+ +-+ +-+ +-+-+ +-+-+-+ + +-+ +
|   |   |   |   |   | |   |     |   |   |
+-+ +-+-+ +-+ +-+ +-+ + +-+ +-+ +-+-+ +-+
|       | |       | |   |   |       |   |
+ +-+-+-+ +-+-+-+-+ + +-+ +-+-+-+-+ + + +
|       | |       | |   |       |   | | |
+ +-+-+ + + +-+-+ + +-+ +-+-+-+ + +-+ + +
| |   | |   |   | |       |     |   | | |
+ +-+ + +-+-+ +-+ +-+-+-+-+ +-+-+-+ +-+ +
| |   | |   |   | |   |     | |   |   | |
+ + + + + + + + + + + + +-+-+ + + +-+ + +
|   | |   |   |     |   |       |       |
+-+-+-+-+-+-+-+-+-+-+-+-+-+-+-+-+-+-+-+-+
