5
5
+-+-+-+-+-+
|         |
+-+-+-+-+ +
|     |   |
+ + +-+ +-+
| |     | |
+ +-+-+-+ +
| |     | |
+ + +-+ + +
|   |     |
+-+-+-+-+-+
